{
  "name": "Level Four",
  "width": 30,
  "height": 30,
  "tiles": [
    [0,0,0,0,0,0,0,0,0,0,0,0,0,0,0,0,0,0,0,0,0,0,0,0,0,0,0,0,0,0],
    [0,0,0,0,0,0,0,0,0,0,0,0,0,0,0,0,0,0,0,0,0,0,0,0,0,0,0,0,0,0],
    [0,0,0,0,0,0,0,0,0,0,2,2,2,2,2,0,0,0,0,0,0,0,0,0,0,0,0,0,0,0],
    [0,0,0,0,0,0,2,2,2,2,1,4,1,1,1,2,0,0,0,0,0,0,0,0,0,0,0,0,0,0],
    [0,0,0,0,0,0,2,1,1,1,1,1,1,1,1,1,2,0,0,0,0,0,0,0,0,0,0,0,0,0],
    [0,0,0,0,2,2,4,1,1,1,1,1,1,1,1,1,1,2,0,0,0,0,0,0,0,0,0,0,0,0],
    [0,0,0,0,2,1,1,1,1,1,1,1,1,1,1,1,1,2,0,0,0,0,0,0,0,0,0,0,0,0],
    [0,0,0,2,3,3,3,3,3,3,3,3,3,3,3,3,3,1,2,2,0,0,0,0,0,0,0,0,0,0],
    [0,0,2,1,3,1,1,1,1,1,1,1,1,1,1,1,3,1,4,2,2,2,0,0,0,0,0,0,0,0],
    [0,2,1,1,3,1,3,1,3,1,3,1,3,1,3,1,3,1,1,1,1,2,0,0,0,0,0,0,0,0],
    [0,2,1,1,3,1,3,1,3,1,3,1,3,1,3,1,3,4,1,1,1,2,0,0,0,0,0,0,0,0],
    [0,0,2,1,3,1,1,1,1,1,1,1,1,1,1,1,1,3,1,1,2,2,0,0,0,0,0,0,0,0],
    [0,0,2,1,3,3,3,3,3,3,3,3,3,3,3,3,3,1,1,2,0,0,0,0,0,0,0,0,0,0],
    [0,0,2,2,1,4,1,4,1,4,1,1,1,1,1,1,1,1,1,2,0,0,0,0,0,0,0,0,0,0],
    [0,0,0,0,2,1,1,1,1,1,1,1,1,1,1,1,1,1,2,0,0,0,0,0,0,0,0,0,0,0],
    [0,0,0,0,0,2,2,2,1,1,1,1,1,1,1,1,4,2,0,0,0,0,0,0,0,0,0,0,0,0],
    [0,0,0,0,0,0,0,0,2,1,1,1,1,1,1,1,2,0,0,0,0,0,0,0,0,0,0,0,0,0],
    [0,0,0,0,0,0,0,0,0,2,1,1,4,1,2,2,0,0,0,0,0,0,0,0,0,0,0,0,0,0],
    [0,0,0,0,0,0,0,0,0,0,2,2,2,2,2,0,0,0,0,0,0,0,0,0,0,0,0,0,0,0],
    [0,0,0,0,0,0,0,0,0,0,0,0,0,0,0,0,0,0,0,0,0,0,0,0,0,0,0,0,0,0],
    [0,0,0,0,0,0,0,0,0,0,0,0,0,0,0,0,0,0,0,0,0,0,0,0,0,0,0,0,0,0],
    [0,0,0,0,0,0,0,0,0,0,0,0,0,0,0,0,0,0,0,0,0,0,0,0,0,0,0,0,0,0],
    [0,0,0,0,0,0,0,0,0,0,0,0,0,0,0,0,0,0,0,0,0,0,0,0,0,0,0,0,0,0],
    [0,0,0,0,0,0,0,0,0,0,0,0,0,0,0,0,0,0,0,0,0,0,0,0,0,0,0,0,0,0],
    [0,0,0,0,0,0,0,0,0,0,0,0,0,0,0,0,0,0,0,0,0,0,0,0,0,0,0,0,0,0],
    [0,0,0,0,0,0,0,0,0,0,0,0,0,0,0,0,0,0,0,0,0,0,0,0,0,0,0,0,0,0],
    [0,0,0,0,0,0,0,0,0,0,0,0,0,0,0,0,0,0,0,0,0,0,0,0,0,0,0,0,0,0],
    [0,0,0,0,0,0,0,0,0,0,0,0,0,0,0,0,0,0,0,0,0,0,0,0,0,0,0,0,0,0],
    [0,0,0,0,0,0,0,0,0,0,0,0,0,0,0,0,0,0,0,0,0,0,0,0,0,0,0,0,0,0],
    [0,0,0,0,0,0,0,0,0,0,0,0,0,0,0,0,0,0,0,0,0,0,0,0,0,0,0,0,0,0]
],
  "entities": [
    {
      "x": 16,
      "y": 11,
      "texture": "parrot",
      "size": 30
    },
    {
      "x": 5,
      "y": 8,
      "texture": "mapPiece",
      "size": 30
    },
    {
      "x": 12, 
      "y": 10,
      "texture":"cannon",
      "interval": 1,
      "size":30,
      "vx":1,
      "vy":0
    },
    {
      "x": 14, 
      "y": 10,
      "texture":"cannon",
      "interval": 1,
      "size":30,
      "vx":1,
      "vy":0
    },
    {
      "x": 10, 
      "y": 10,
      "texture":"cannon",
      "interval": 1,
      "size":30,
      "vx":1,
      "vy":0
    },
    {
      "x": 8, 
      "y": 10,
      "texture":"cannon",
      "interval": 1,
      "size":30,
      "vx":1,
      "vy":0
    },
    {
      "x": 6, 
      "y": 10,
      "texture":"cannon",
      "interval": 1,
      "size":30,
      "vx":1,
      "vy":0
    },
    {
      "x": 4, 
      "y": 10,
      "texture":"cannon",
      "interval": 1,
      "size":30,
      "vx":1,
      "vy":0
    },
    {
      "x": 16,
      "y": 10,
      "texture": "switchBarrier",
      "size": 30,
      "status": 0
    }
  ]
}