{
  "name": "Level One: Commands",
  "width": 30,
  "height": 30,
  "tiles": [
    [0,0,0,0,0,0,0,0,0,0,0,0,2,2,0,0,0,0,0,0,0,0,0,0,0,0,0,0,0,0],
    [0,0,0,0,0,0,0,0,0,0,0,2,2,1,2,0,0,0,0,0,0,0,0,0,0,0,0,0,0,0],
    [0,0,0,0,0,0,0,0,0,0,2,1,1,4,1,2,0,0,0,0,0,0,0,0,0,0,0,0,0,0],
    [0,0,0,0,0,0,0,0,0,2,1,1,1,1,1,1,2,0,0,0,0,0,0,0,0,0,0,0,0,0],
    [0,0,0,0,0,0,0,0,2,1,1,3,3,3,3,1,1,2,0,0,0,0,0,0,0,0,0,0,0,0],
    [0,0,0,0,0,0,0,2,2,1,1,3,1,1,3,1,4,1,2,0,0,0,0,0,0,0,0,0,0,0],
    [0,0,0,0,0,0,2,2,1,1,1,3,3,1,3,1,1,1,1,2,0,0,0,0,0,0,0,0,0,0],
    [0,0,2,2,2,2,2,1,1,1,1,3,3,1,3,1,1,1,1,2,2,2,2,2,0,0,0,0,0,0],
    [0,0,2,1,1,1,1,1,1,4,1,3,1,1,3,4,1,1,1,1,1,1,1,4,2,0,0,0,0,0],
    [0,0,2,1,4,1,1,1,1,1,1,3,3,1,3,1,1,1,1,1,1,1,1,1,2,0,0,0,0,0],
    [0,0,2,2,1,1,1,1,1,1,1,3,3,1,3,1,1,1,1,1,4,1,1,2,0,0,0,0,0,0],
    [0,0,0,2,1,1,1,1,1,1,1,3,1,1,3,1,1,1,1,1,1,1,1,2,0,0,0,0,0,0],
    [0,0,0,2,2,1,1,1,1,1,1,3,3,1,3,1,1,4,1,1,1,2,2,0,0,0,0,0,0,0],
    [0,0,0,0,2,2,1,1,4,1,1,1,3,1,3,1,1,1,1,1,2,0,0,0,0,0,0,0,0,0],
    [0,0,0,0,0,2,2,1,1,1,1,3,3,1,3,3,1,1,1,1,2,0,0,0,0,0,0,0,0,0],
    [0,0,0,0,0,0,2,2,1,1,1,3,1,1,1,3,1,1,4,2,0,0,0,0,0,0,0,0,0,0],
    [0,0,0,0,0,0,0,2,2,1,1,3,3,1,3,3,1,1,2,0,0,0,0,0,0,0,0,0,0,0],
    [0,0,0,0,0,0,0,0,2,2,1,4,3,1,3,1,1,2,0,0,0,0,0,0,0,0,0,0,0,0],
    [0,0,0,0,0,0,0,0,0,2,1,1,3,3,3,1,2,0,0,0,0,0,0,0,0,0,0,0,0,0],
    [0,0,0,0,0,0,0,0,0,0,2,2,2,2,2,2,0,0,0,0,0,0,0,0,0,0,0,0,0,0],
    [0,0,0,0,0,0,0,0,0,0,0,0,0,0,0,0,0,0,0,0,0,0,0,0,0,0,0,0,0,0],
    [0,0,0,0,0,0,0,0,0,0,0,0,0,0,0,0,0,0,0,0,0,0,0,0,0,0,0,0,0,0],
    [0,0,0,0,0,0,0,0,0,0,0,0,0,0,0,0,0,0,0,0,0,0,0,0,0,0,0,0,0,0],
    [0,0,0,0,0,0,0,0,0,0,0,0,0,0,0,0,0,0,0,0,0,0,0,0,0,0,0,0,0,0],
    [0,0,0,0,0,0,0,0,0,0,0,0,0,0,0,0,0,0,0,0,0,0,0,0,0,0,0,0,0,0],
    [0,0,0,0,0,0,0,0,0,0,0,0,0,0,0,0,0,0,0,0,0,0,0,0,0,0,0,0,0,0],
    [0,0,0,0,0,0,0,0,0,0,0,0,0,0,0,0,0,0,0,0,0,0,0,0,0,0,0,0,0,0],
    [0,0,0,0,0,0,0,0,0,0,0,0,0,0,0,0,0,0,0,0,0,0,0,0,0,0,0,0,0,0],
    [0,0,0,0,0,0,0,0,0,0,0,0,0,0,0,0,0,0,0,0,0,0,0,0,0,0,0,0,0,0],
    [0,0,0,0,0,0,0,0,0,0,0,0,0,0,0,0,0,0,0,0,0,0,0,0,0,0,0,0,0,0]
],
  "entities": [
    {
      "x": 12,
      "y": 5,
      "texture": "parrot",
      "size": 30
    },
    {
      "x": 13,
      "y": 10,
      "texture": "mapPiece",
      "size": 30
    }
  ]
}