{
  "name": "Level Five",
  "width": 30,
  "height": 30,
  "tiles": [
    [0,0,0,0,0,0,0,0,0,0,0,0,0,0,0,0,0,0,0,0,0,0,0,0,0,0,0,0,0,0],
    [0,0,0,0,0,0,0,0,0,0,0,0,0,0,0,0,0,0,0,0,0,0,0,0,0,0,0,0,0,0],
    [0,0,0,0,0,2,2,2,2,2,2,2,2,2,2,2,2,2,0,0,0,0,0,0,0,0,0,0,0,0],
    [0,0,0,0,2,2,1,1,1,1,1,1,1,1,1,4,1,2,2,2,0,0,0,0,0,0,0,0,0,0],
    [0,0,0,0,2,1,1,4,1,1,1,1,1,1,1,1,1,1,1,2,0,0,0,0,0,0,0,0,0,0],
    [0,0,0,2,2,1,1,1,1,1,1,4,1,1,1,4,1,1,1,1,2,0,0,0,0,0,0,0,0,0],
    [0,2,2,2,1,4,1,1,1,1,1,1,1,4,1,1,1,1,1,1,1,2,0,0,0,0,0,0,0,0],
    [0,2,1,1,1,1,1,1,1,1,1,1,1,1,1,1,1,1,1,1,1,1,2,0,0,0,0,0,0,0],
    [0,2,4,1,1,3,3,3,3,3,3,3,3,3,3,3,3,3,3,3,3,1,2,2,2,2,2,0,0,0],
    [0,2,1,1,1,3,1,1,1,1,1,1,1,1,1,1,1,1,1,1,3,1,1,1,4,1,2,0,0,0],
    [0,2,1,1,1,3,3,3,3,1,3,1,3,1,3,1,3,1,3,3,3,1,1,1,2,2,0,0,0,0],
    [0,2,2,1,1,1,1,1,3,3,3,3,3,3,3,3,3,3,3,1,1,1,1,2,2,0,0,0,0,0],
    [0,0,0,2,4,1,1,1,1,1,1,1,1,1,4,1,1,1,4,1,1,2,2,0,0,0,0,0,0,0],
    [0,0,0,2,1,1,1,4,1,4,1,1,1,1,1,1,1,1,1,1,2,2,0,0,0,0,0,0,0,0],
    [0,0,0,2,2,1,1,1,1,1,1,1,1,1,1,1,1,1,1,1,2,0,0,0,0,0,0,0,0,0],
    [0,0,0,0,2,2,2,2,1,1,1,1,1,1,1,1,4,1,1,2,2,0,0,0,0,0,0,0,0,0],
    [0,0,0,0,0,0,0,2,2,4,1,1,1,1,1,1,1,2,2,2,0,0,0,0,0,0,0,0,0,0],
    [0,0,0,0,0,0,0,0,2,2,1,1,4,1,1,2,2,2,0,0,0,0,0,0,0,0,0,0,0,0],
    [0,0,0,0,0,0,0,0,0,2,2,2,2,2,2,2,0,0,0,0,0,0,0,0,0,0,0,0,0,0],
    [0,0,0,0,0,0,0,0,0,0,0,0,0,0,0,0,0,0,0,0,0,0,0,0,0,0,0,0,0,0],
    [0,0,0,0,0,0,0,0,0,0,0,0,0,0,0,0,0,0,0,0,0,0,0,0,0,0,0,0,0,0],
    [0,0,0,0,0,0,0,0,0,0,0,0,0,0,0,0,0,0,0,0,0,0,0,0,0,0,0,0,0,0],
    [0,0,0,0,0,0,0,0,0,0,0,0,0,0,0,0,0,0,0,0,0,0,0,0,0,0,0,0,0,0],
    [0,0,0,0,0,0,0,0,0,0,0,0,0,0,0,0,0,0,0,0,0,0,0,0,0,0,0,0,0,0],
    [0,0,0,0,0,0,0,0,0,0,0,0,0,0,0,0,0,0,0,0,0,0,0,0,0,0,0,0,0,0],
    [0,0,0,0,0,0,0,0,0,0,0,0,0,0,0,0,0,0,0,0,0,0,0,0,0,0,0,0,0,0],
    [0,0,0,0,0,0,0,0,0,0,0,0,0,0,0,0,0,0,0,0,0,0,0,0,0,0,0,0,0,0],
    [0,0,0,0,0,0,0,0,0,0,0,0,0,0,0,0,0,0,0,0,0,0,0,0,0,0,0,0,0,0],
    [0,0,0,0,0,0,0,0,0,0,0,0,0,0,0,0,0,0,0,0,0,0,0,0,0,0,0,0,0,0],
    [0,0,0,0,0,0,0,0,0,0,0,0,0,0,0,0,0,0,0,0,0,0,0,0,0,0,0,0,0,0]
],
  "entities": [
    {
      "x": 6,
      "y": 9,
      "texture": "parrot",
      "size": 30
    },
    {
      "x": 19,
      "y": 9,
      "texture": "treasure",
      "size": 30
    },
    {
      "x": 10, 
      "y": 7,
      "texture":"cannon",
      "size":30,
      "vx":0,
      "vy":1
    },
    {
      "x": 4, 
      "y": 9,
      "texture":"cannon",
      "interval": 3,
      "size":30,
      "vx":1,
      "vy":0
    },
    {
      "x": 12, 
      "y": 7,
      "texture":"cannon",
      "size":30,
      "vx":0,
      "vy":1
    },
    {
      "x": 14, 
      "y": 7,
      "texture":"cannon",
      "size":30,
      "vx":0,
      "vy":1
    },
    {
      "x": 16, 
      "y": 7,
      "texture":"cannon",
      "interval": 4,
      "size":30,
      "vx":0,
      "vy":1
    },
    {
      "x": 18, 
      "y": 7,
      "texture":"cannon",
      "interval": 3,
      "size":30,
      "vx":0,
      "vy":1
    }
  ]
}