{
  "name": "Level Seven",
  "width": 30,
  "height": 30,
  "tiles": [
    [0,0,0,0,0,0,0,0,0,0,0,0,0,0,0,0,0,0,0,0,0,0,0,0,0,0,0,0,0,0],
    [0,0,0,0,0,0,0,0,0,0,0,0,0,0,0,0,0,0,0,0,0,0,0,0,0,0,0,0,0,0],
    [0,0,0,0,0,2,2,2,2,2,2,2,2,2,2,2,2,2,0,0,0,0,0,0,0,0,0,0,0,0],
    [0,0,0,0,2,2,1,1,1,1,1,1,1,1,1,4,1,2,2,2,0,0,0,0,0,0,0,0,0,0],
    [0,0,0,0,2,1,1,4,1,1,1,1,1,1,1,1,1,1,1,2,0,0,0,0,0,0,0,0,0,0],
    [0,0,0,2,2,1,1,1,1,1,1,4,1,1,1,4,1,1,1,1,2,0,0,0,0,0,0,0,0,0],
    [0,2,2,2,1,4,1,1,1,1,3,3,3,4,1,1,1,1,1,1,1,2,0,0,0,0,0,0,0,0],
    [0,2,1,1,1,1,1,1,1,1,3,1,3,3,3,3,3,1,1,1,1,1,2,0,0,0,0,0,0,0],
    [0,2,4,1,1,1,1,1,1,1,3,1,1,1,1,1,3,1,1,1,1,1,2,2,2,2,2,0,0,0],
    [0,2,1,1,1,1,1,1,1,1,3,1,1,1,1,1,3,1,1,1,1,1,1,1,4,1,2,0,0,0],
    [0,2,1,1,1,1,1,1,1,1,3,1,1,1,1,1,3,1,1,1,1,1,1,1,2,2,0,0,0,0],
    [0,2,2,1,1,1,1,1,1,1,3,1,1,1,1,1,3,1,1,1,1,1,1,2,2,0,0,0,0,0],
    [0,0,0,2,4,1,1,1,1,1,3,1,1,1,1,1,3,1,4,1,1,2,2,0,0,0,0,0,0,0],
    [0,0,0,2,1,1,1,4,1,4,3,3,3,3,3,1,3,1,1,1,2,2,0,0,0,0,0,0,0,0],
    [0,0,0,2,2,1,1,1,1,1,1,1,1,1,3,3,3,1,1,1,2,0,0,0,0,0,0,0,0,0],
    [0,0,0,0,2,2,2,2,1,1,1,1,1,1,1,1,4,1,1,2,2,0,0,0,0,0,0,0,0,0],
    [0,0,0,0,0,0,0,2,2,4,1,1,1,1,1,1,1,2,2,2,0,0,0,0,0,0,0,0,0,0],
    [0,0,0,0,0,0,0,0,2,2,1,1,4,1,1,2,2,2,0,0,0,0,0,0,0,0,0,0,0,0],
    [0,0,0,0,0,0,0,0,0,2,2,2,2,2,2,2,0,0,0,0,0,0,0,0,0,0,0,0,0,0],
    [0,0,0,0,0,0,0,0,0,0,0,0,0,0,0,0,0,0,0,0,0,0,0,0,0,0,0,0,0,0],
    [0,0,0,0,0,0,0,0,0,0,0,0,0,0,0,0,0,0,0,0,0,0,0,0,0,0,0,0,0,0],
    [0,0,0,0,0,0,0,0,0,0,0,0,0,0,0,0,0,0,0,0,0,0,0,0,0,0,0,0,0,0],
    [0,0,0,0,0,0,0,0,0,0,0,0,0,0,0,0,0,0,0,0,0,0,0,0,0,0,0,0,0,0],
    [0,0,0,0,0,0,0,0,0,0,0,0,0,0,0,0,0,0,0,0,0,0,0,0,0,0,0,0,0,0],
    [0,0,0,0,0,0,0,0,0,0,0,0,0,0,0,0,0,0,0,0,0,0,0,0,0,0,0,0,0,0],
    [0,0,0,0,0,0,0,0,0,0,0,0,0,0,0,0,0,0,0,0,0,0,0,0,0,0,0,0,0,0],
    [0,0,0,0,0,0,0,0,0,0,0,0,0,0,0,0,0,0,0,0,0,0,0,0,0,0,0,0,0,0],
    [0,0,0,0,0,0,0,0,0,0,0,0,0,0,0,0,0,0,0,0,0,0,0,0,0,0,0,0,0,0],
    [0,0,0,0,0,0,0,0,0,0,0,0,0,0,0,0,0,0,0,0,0,0,0,0,0,0,0,0,0,0],
    [0,0,0,0,0,0,0,0,0,0,0,0,0,0,0,0,0,0,0,0,0,0,0,0,0,0,0,0,0,0]
],
  "entities": [
    {
      "x": 6,
      "y": 9,
      "texture": "parrot",
      "size": 30
    },
    {
      "x": 15,
      "y": 13,
      "texture": "treasure",
      "size": 30
    },
    {
      "x": 11, 
      "y": 7,
      "texture":"switch",
      "size":30
    },
    {
      "x": 17,
      "y": 12,
      "texture": "switchBarrier",
      "size": 30
    },
    {
      "x": 15,
      "y": 6,
      "texture": "switchBarrier",
      "size": 30
    },
    {
      "x": 9,
      "y": 8,
      "texture": "switchBarrier",
      "size": 30
    },
    {
      "x": 11,
      "y": 14,
      "texture": "switchBarrier",
      "size": 30
    },
    {
      "x": 12,
      "y": 14,
      "texture": "switchBarrier",
      "size": 30
    }
  ]
}