{
  "name": "Level Six",
  "width": 30,
  "height": 30,
  "tiles": [
    [0,0,0,0,0,0,0,0,0,0,0,0,2,2,0,0,0,0,0,0,0,0,0,0,0,0,0,0,0,0],
    [0,0,0,0,0,0,0,0,0,0,0,2,2,1,2,0,0,0,0,0,0,0,0,0,0,0,0,0,0,0],
    [0,0,0,0,0,0,0,0,0,0,2,1,1,4,1,2,0,0,0,0,0,0,0,0,0,0,0,0,0,0],
    [0,0,0,0,0,0,0,0,0,2,1,1,1,1,1,1,2,0,0,0,0,0,0,0,0,0,0,0,0,0],
    [0,0,0,0,0,0,0,0,2,1,1,3,3,3,3,1,1,2,0,0,0,0,0,0,0,0,0,0,0,0],
    [0,0,0,0,0,0,0,2,2,1,1,3,1,1,3,1,4,1,2,0,0,0,0,0,0,0,0,0,0,0],
    [0,0,0,0,0,0,2,2,1,1,1,3,3,1,3,1,1,1,1,2,0,0,0,0,0,0,0,0,0,0],
    [0,0,2,2,2,2,2,1,1,1,1,3,3,1,3,1,1,1,1,2,2,2,2,2,0,0,0,0,0,0],
    [0,0,2,1,1,1,1,1,1,4,1,3,1,1,3,4,1,1,1,1,1,1,1,4,2,0,0,0,0,0],
    [0,0,2,1,4,1,1,1,1,1,1,3,3,1,3,1,1,1,1,1,1,1,1,1,2,0,0,0,0,0],
    [0,0,2,2,1,1,1,1,1,1,1,3,3,1,3,1,1,1,1,1,4,1,1,2,0,0,0,0,0,0],
    [0,0,0,2,1,1,1,1,1,1,1,3,1,1,3,1,1,1,1,1,1,1,1,2,0,0,0,0,0,0],
    [0,0,0,2,2,1,1,1,1,1,1,3,3,1,3,1,1,4,1,1,1,2,2,0,0,0,0,0,0,0],
    [0,0,0,0,2,2,1,1,4,1,1,1,3,1,3,1,1,1,1,1,2,0,0,0,0,0,0,0,0,0],
    [0,0,0,0,0,2,2,1,1,1,1,3,1,1,3,3,1,1,1,1,2,0,0,0,0,0,0,0,0,0],
    [0,0,0,0,0,0,2,2,1,1,1,3,3,1,3,3,1,1,4,2,0,0,0,0,0,0,0,0,0,0],
    [0,0,0,0,0,0,0,2,2,1,1,3,3,1,3,3,1,1,2,0,0,0,0,0,0,0,0,0,0,0],
    [0,0,0,0,0,0,0,0,2,2,1,4,3,3,3,1,1,2,0,0,0,0,0,0,0,0,0,0,0,0],
    [0,0,0,0,0,0,0,0,0,2,1,1,1,1,1,1,2,0,0,0,0,0,0,0,0,0,0,0,0,0],
    [0,0,0,0,0,0,0,0,0,0,2,2,2,2,2,2,0,0,0,0,0,0,0,0,0,0,0,0,0,0],
    [0,0,0,0,0,0,0,0,0,0,0,0,0,0,0,0,0,0,0,0,0,0,0,0,0,0,0,0,0,0],
    [0,0,0,0,0,0,0,0,0,0,0,0,0,0,0,0,0,0,0,0,0,0,0,0,0,0,0,0,0,0],
    [0,0,0,0,0,0,0,0,0,0,0,0,0,0,0,0,0,0,0,0,0,0,0,0,0,0,0,0,0,0],
    [0,0,0,0,0,0,0,0,0,0,0,0,0,0,0,0,0,0,0,0,0,0,0,0,0,0,0,0,0,0],
    [0,0,0,0,0,0,0,0,0,0,0,0,0,0,0,0,0,0,0,0,0,0,0,0,0,0,0,0,0,0],
    [0,0,0,0,0,0,0,0,0,0,0,0,0,0,0,0,0,0,0,0,0,0,0,0,0,0,0,0,0,0],
    [0,0,0,0,0,0,0,0,0,0,0,0,0,0,0,0,0,0,0,0,0,0,0,0,0,0,0,0,0,0],
    [0,0,0,0,0,0,0,0,0,0,0,0,0,0,0,0,0,0,0,0,0,0,0,0,0,0,0,0,0,0],
    [0,0,0,0,0,0,0,0,0,0,0,0,0,0,0,0,0,0,0,0,0,0,0,0,0,0,0,0,0,0],
    [0,0,0,0,0,0,0,0,0,0,0,0,0,0,0,0,0,0,0,0,0,0,0,0,0,0,0,0,0,0]
],
  "entities": [
    {
      "x": 12,
      "y": 5,
      "texture": "parrot",
      "size": 30
    },
    {
      "x": 13,
      "y": 16,
      "texture": "mapPiece",
      "size": 30
    },
    {
      "x": 13, 
      "y": 18,
      "texture":"cannon",
      "interval": 10,
      "size":30,
      "vx":0,
      "vy":-1,
      "timer":8
    },
  {
    "x": 15, 
    "y": 9,
    "texture":"cannon",
    "interval": 2,
    "size":30,
    "vx":-1,
    "vy":0
  },
  {
    "x": 15, 
    "y": 12,
    "texture":"cannon",
    "interval": 3,
    "size":30,
    "vx":-1,
    "vy":0
  }
  ]
}