{
  "name": "Level Three",
  "width": 30,
  "height": 30,
  "tiles": [
    [0,0,0,0,0,0,0,0,0,0,0,0,0,0,0,0,0,0,0,0,0,0,0,0,0,0,0,0,0,0],
    [0,0,0,0,0,0,0,0,0,0,0,0,0,0,0,0,0,0,0,0,0,0,0,0,0,0,0,0,0,0],
    [0,0,0,0,0,0,0,0,0,0,0,0,0,0,0,0,0,0,0,0,0,0,0,0,0,0,0,0,0,0],
    [0,0,0,0,0,0,0,0,0,0,0,0,0,0,0,0,0,0,0,0,0,0,0,0,0,0,0,0,0,0],
    [0,0,0,0,0,0,0,0,0,0,0,0,0,0,0,0,0,0,0,0,0,0,0,0,0,0,0,0,0,0],
    [0,0,0,0,0,0,0,0,0,0,0,0,0,0,0,0,0,0,0,0,0,0,0,0,0,0,0,0,0,0],
    [0,0,0,0,0,0,0,2,2,2,2,2,2,2,2,0,0,0,0,0,0,0,0,0,0,0,0,0,0,0],
    [0,0,0,0,0,2,2,2,1,1,1,1,3,1,2,2,2,2,0,0,0,0,0,0,0,0,0,0,0,0],
    [0,0,0,2,2,2,2,1,1,1,1,3,3,3,1,1,1,2,2,0,0,0,0,0,0,0,0,0,0,0],
    [0,0,2,2,1,1,4,1,1,1,1,3,1,3,1,1,1,1,2,2,0,0,0,0,0,0,0,0,0,0],
    [0,0,2,2,1,1,1,1,1,1,1,3,1,3,1,1,4,1,1,2,2,0,0,0,0,0,0,0,0,0],
    [0,0,0,2,1,1,1,1,4,1,3,3,1,3,3,1,1,1,2,2,0,0,0,0,0,0,0,0,0,0],
    [0,0,0,2,2,1,1,1,1,1,3,1,1,4,3,1,1,1,2,0,0,0,0,0,0,0,0,0,0,0],
    [0,0,0,0,2,1,4,1,1,1,3,4,1,1,3,1,4,1,2,0,0,0,0,0,0,0,0,0,0,0],
    [0,0,0,0,2,2,1,1,1,4,3,3,1,3,3,1,1,1,2,0,0,0,0,0,0,0,0,0,0,0],
    [0,0,0,0,0,2,1,1,1,1,1,3,3,3,1,1,1,2,2,0,0,0,0,0,0,0,0,0,0,0],
    [0,0,0,0,0,0,2,1,1,1,1,4,3,1,4,1,1,2,0,0,0,0,0,0,0,0,0,0,0,0],
    [0,0,0,0,0,0,0,2,2,1,1,1,1,1,1,1,2,2,0,0,0,0,0,0,0,0,0,0,0,0],
    [0,0,0,0,0,0,0,0,2,2,2,2,2,2,2,2,2,0,0,0,0,0,0,0,0,0,0,0,0,0],
    [0,0,0,0,0,0,0,0,0,0,0,0,0,0,0,0,0,0,0,0,0,0,0,0,0,0,0,0,0,0],
    [0,0,0,0,0,0,0,0,0,0,0,0,0,0,0,0,0,0,0,0,0,0,0,0,0,0,0,0,0,0],
    [0,0,0,0,0,0,0,0,0,0,0,0,0,0,0,0,0,0,0,0,0,0,0,0,0,0,0,0,0,0],
    [0,0,0,0,0,0,0,0,0,0,0,0,0,0,0,0,0,0,0,0,0,0,0,0,0,0,0,0,0,0],
    [0,0,0,0,0,0,0,0,0,0,0,0,0,0,0,0,0,0,0,0,0,0,0,0,0,0,0,0,0,0],
    [0,0,0,0,0,0,0,0,0,0,0,0,0,0,0,0,0,0,0,0,0,0,0,0,0,0,0,0,0,0],
    [0,0,0,0,0,0,0,0,0,0,0,0,0,0,0,0,0,0,0,0,0,0,0,0,0,0,0,0,0,0],
    [0,0,0,0,0,0,0,0,0,0,0,0,0,0,0,0,0,0,0,0,0,0,0,0,0,0,0,0,0,0],
    [0,0,0,0,0,0,0,0,0,0,0,0,0,0,0,0,0,0,0,0,0,0,0,0,0,0,0,0,0,0],
    [0,0,0,0,0,0,0,0,0,0,0,0,0,0,0,0,0,0,0,0,0,0,0,0,0,0,0,0,0,0],
    [0,0,0,0,0,0,0,0,0,0,0,0,0,0,0,0,0,0,0,0,0,0,0,0,0,0,0,0,0,0]
],
  "entities": [
    {
      "x": 12,
      "y": 9,
      "texture": "parrot",
      "size": 30
    },
    {
      "x": 12,
      "y": 14,
      "texture": "treasure",
      "size": 30
    },
    {
      "x": 15, 
      "y": 13,
      "texture":"cannon",
      "interval": 2,
      "size":30,
      "vx":-1,
      "vy":0
    }
  ]
}