{
  "name": "Level Four",
  "width": 30,
  "height": 30,
  "tiles": [
    [0,0,0,0,0,0,0,0,0,0,0,0,0,0,0,0,0,0,0,0,0,0,0,0,0,0,0,0,0,0],
    [0,0,0,0,0,0,0,0,0,0,0,0,0,0,0,0,0,0,0,0,0,0,0,0,0,0,0,0,0,0],
    [0,0,0,0,0,0,0,0,0,0,2,2,2,2,2,0,0,0,0,0,0,0,0,0,0,0,0,0,0,0],
    [0,0,0,0,0,0,2,2,2,2,1,4,1,1,1,2,0,0,0,0,0,0,0,0,0,0,0,0,0,0],
    [0,0,0,0,0,0,2,1,1,1,1,1,1,1,1,1,2,0,0,0,0,0,0,0,0,0,0,0,0,0],
    [0,0,0,0,2,2,4,1,1,1,1,1,1,1,1,1,1,2,0,0,0,0,0,0,0,0,0,0,0,0],
    [0,0,0,0,2,1,1,1,1,1,3,3,3,3,3,1,1,2,0,0,0,0,0,0,0,0,0,0,0,0],
    [0,0,0,2,1,1,1,1,1,1,3,1,1,1,3,1,1,1,2,2,0,0,0,0,0,0,0,0,0,0],
    [0,0,2,1,1,1,1,4,1,1,3,1,3,1,3,1,1,1,4,2,2,2,0,0,0,0,0,0,0,0],
    [0,2,1,1,1,4,1,1,1,1,3,1,3,1,3,1,1,1,1,1,1,2,0,0,0,0,0,0,0,0],
    [0,2,1,1,1,1,1,1,1,1,3,1,3,1,3,1,1,4,1,1,1,2,0,0,0,0,0,0,0,0],
    [0,0,2,1,1,1,1,1,1,1,3,1,1,1,3,1,1,1,1,1,2,2,0,0,0,0,0,0,0,0],
    [0,0,2,1,4,1,1,1,1,1,3,3,1,3,3,1,1,1,1,2,0,0,0,0,0,0,0,0,0,0],
    [0,0,2,2,1,1,1,4,1,4,1,3,1,3,1,1,1,1,1,2,0,0,0,0,0,0,0,0,0,0],
    [0,0,0,0,2,1,1,1,1,1,1,3,1,3,1,1,1,1,2,0,0,0,0,0,0,0,0,0,0,0],
    [0,0,0,0,0,2,2,2,1,1,1,3,1,3,1,1,4,2,0,0,0,0,0,0,0,0,0,0,0,0],
    [0,0,0,0,0,0,0,0,2,1,1,3,3,3,1,1,2,0,0,0,0,0,0,0,0,0,0,0,0,0],
    [0,0,0,0,0,0,0,0,0,2,1,1,4,1,2,2,0,0,0,0,0,0,0,0,0,0,0,0,0,0],
    [0,0,0,0,0,0,0,0,0,0,2,2,2,2,2,0,0,0,0,0,0,0,0,0,0,0,0,0,0,0],
    [0,0,0,0,0,0,0,0,0,0,0,0,0,0,0,0,0,0,0,0,0,0,0,0,0,0,0,0,0,0],
    [0,0,0,0,0,0,0,0,0,0,0,0,0,0,0,0,0,0,0,0,0,0,0,0,0,0,0,0,0,0],
    [0,0,0,0,0,0,0,0,0,0,0,0,0,0,0,0,0,0,0,0,0,0,0,0,0,0,0,0,0,0],
    [0,0,0,0,0,0,0,0,0,0,0,0,0,0,0,0,0,0,0,0,0,0,0,0,0,0,0,0,0,0],
    [0,0,0,0,0,0,0,0,0,0,0,0,0,0,0,0,0,0,0,0,0,0,0,0,0,0,0,0,0,0],
    [0,0,0,0,0,0,0,0,0,0,0,0,0,0,0,0,0,0,0,0,0,0,0,0,0,0,0,0,0,0],
    [0,0,0,0,0,0,0,0,0,0,0,0,0,0,0,0,0,0,0,0,0,0,0,0,0,0,0,0,0,0],
    [0,0,0,0,0,0,0,0,0,0,0,0,0,0,0,0,0,0,0,0,0,0,0,0,0,0,0,0,0,0],
    [0,0,0,0,0,0,0,0,0,0,0,0,0,0,0,0,0,0,0,0,0,0,0,0,0,0,0,0,0,0],
    [0,0,0,0,0,0,0,0,0,0,0,0,0,0,0,0,0,0,0,0,0,0,0,0,0,0,0,0,0,0],
    [0,0,0,0,0,0,0,0,0,0,0,0,0,0,0,0,0,0,0,0,0,0,0,0,0,0,0,0,0,0]
],
  "entities": [
    {
      "x": 12,
      "y": 15,
      "texture": "parrot",
      "size": 30
    },
    {
      "x": 12,
      "y": 7,
      "texture": "treasure",
      "size": 30
    },
    {
      "x": 13, 
      "y": 5,
      "texture":"cannon",
      "interval": 1,
      "size":30,
      "vx":0,
      "vy":1
    },
    {
      "x": 11, 
      "y": 5,
      "texture":"cannon",
      "interval": 1,
      "size":30,
      "vx":0,
      "vy":1
    }
  ]
}